1111111111111111
1E0000C00000C001
1010010101001101
1010010001001101
1010010101001101
1010010001001101
1P000000000000C1
1111111111111111