1111111111111111
1E00X0C00000C001
1010010101001101
10100100010011X1
1X100101010X1101
1010010001001101
1P00000X000000C1
1111111111111111